R 960 540
NO ./textures/wall_1.xpm
SO ./textures/wall_2.xpm
WE ./textures/wall_3.xpm
EA ./textures/wall_4.xpm
S ./textures/sprite_1.xpm
F 225,80,0
C 0,225,225

        1111111111111111111111111
        1000000000110000000000001
        1011000001110000000000001
        100100000000000W000000001
111111111011000001110000000000001
100000000011000001111111110111111
11110111111111011100000010001
11110111111111011101010010001
11000000110101011100000010001
10002000000000001100000010001
10000000000000001101010010001
1100000111010101111101111000111
11110111 1110101 101111010001
11111111 1111111 111111111111
