111111
100101
102001
1100W1
111111
