R 1920 1080
NO ./cub3d_textures/wood.xpm
WE ./cub3d_textures/wall_3.xpm
SO ./cub3d_textures/bluestone.xpm
EA ./cub3d_textures/wall_4.xpm
S ./cub3d_textures/sprite_2.xpm
F 220,100,0
C 225,30,0

11111111111111111111111111111111111111111111111111111111111
1000000000000000000000000000000000000000100000000000000000
1000000000000000000000000000000000000000100000000000000000
1000000000000000000000000000000000000000100000000000000000
1000000000000000000000000000000000000000100000000000222000
1000000000000000000000000000000000000000100000000000222000
1000000000000000000000000000000000000000100000000000000000
1011100000000000000000000000000000000000100000000000000000
101 100000000000000000000000000000000000111111111111100000
101 100000000000000000000000000000000000000000000000000000
101 100000000000000000000000000000000000000111111100011100
101 1000001111110000011111100000111111000001      1111 100
101 1000001    1000001    1000001    1000001       111 100
101 1000001    1000001    1000001    1000001        11 100
101 1000001    1000001    1000001    1000001         1 100
101 1000001    1000002    1000001    100000000000000000000
101 1000001    1000001    1000001    100N001           200
101 1000001    1000001    1000001    1000001        000000
121 1000001    1000001    1000001    100000000000000000000
111 1111111    1111111    1111111    1111111
