R 1920 1080
NO ./cub3d_textures/wood.xpm
WE ./cub3d_textures/wall_3.xpm
SO ./cub3d_textures/bluestone.xpm
EA ./cub3d_textures/wall_4.xpm
S ./cub3d_textures/sprite_1.xpm
F 220,100,0
C 225,30,0

11111111111111111111111111111111111111111111111111111111111
10000000000000000000000000000000000000001000000000000000001
10000000000000000000000000000000000000001000000000000000001
10000000000000000000000000000000000000001000000000000000001
10000000000000000000000000000000000000001000000000002220001
10000000000000000000000000000000000000001000000000002220001
10000000000000000000000000000000000000001000000000000000001
10111000000000000000000000000000000000001000000000000000001
101 1000000000000000000000000000000000001111111111111000001
101 1000000000000000000000000000000000000000000000000000001
101 1000000000000000000000000000000000000001111111000111001
101 1000001111110000011111100000111111000001      1111 1001
101 1000001    1000001    1000001    1000001       111 1001
101 1000001    1000001    1000001    1000001        11 10011
101 1000001    1000001    1000001    1000001         1 1001
101 1000001    1000001    1000001    1000001           1001
101 1000001    1000001    1000001    1000001           1001
101 1000001    1000001    1000001    1000001           10N1
121 1000001    1000001    1000001    1000001           1111
111 1111111    1111111    1111111    1111111
