R 1920 1080
NO ./cub3d_textures/wall_1.xpm
SO ./cub3d_textures/wall_2.xpm
WE ./cub3d_textures/wall_3.xpm
EA ./cub3d_textures/wall_4.xpm
S ./cub3d_textures/sprite_1.xpm
F 220,100,0
C 225,30,0

111111111111                     111111111111111111
100000000001111111111111111111111100000000000000221
100000000000000000000000000000000000000000000000221
100000000000111111111111111111111100000000111111111
1000000000001            11111111100000000000000001
1000000000001            10000000000000000000000001
1000000000001            10000000000000000000000001
1000000000001            10000000000000000000000001
100000000000111111111111110000000011111111110000001
10000000000000000000000000000000001        10000001
100000000000000000000000000000000001       10000001
10000011111111111111111000000000000011     10000001
1000001               1000000000000001     10000001
1000001               1000000000000001     10000001
100N001               1222222222222221     10222201
1111111               1111111111111111     11111111
