R 1920 1080
NO ./cub3d_textures/wall_1.xpm
SO ./cub3d_textures/wall_2.xpm
WE ./cub3d_textures/wall_3.xpm
EA ./cub3d_textures/wall_4.xpm
S ./cub3d_textures/sprite_3.xpm
F 220,100,0
C 225,30,0

111111111111101111111111111
 1000000000000000000000001
  10000000000000000000001
   100000000000000000001
    1000000000000000001
     10000000000000001
      100000000000001
       1000000000001
        10000000001
         100000001
          1002001
           10001
            101
            101
            101
           10001
          1000001
         1000N0001
        10000000001
       1000000000001
      100000000000001
     10000000000000001
    1000000000000000001
   100000000000000000001
  10000000000000000000001
 1000000000000000000000001
111111111111111111111111111
