R 1920 1080
NO ./cub3d_textures/wall_1.xpm
SO ./cub3d_textures/wall_2.xpm
WE ./cub3d_textures/wall_3.xpm
EA ./cub3d_textures/wall_4.xpm
S ./cub3d_textures/sprite_2.xpm
F 225,80,225
C 0,225,225

        1111111111111111111111111
        1000000000110000000000001
        1011000001110000000200001
        100100E000000000000000001
111111111011000001110000000000001
100000000011000001110111110111111
11110111111111011100000010001
111101111111110111010100100011111
110000001101010111000000100000001
100020000000000000000000100011111
10000000000000001101010000001
1100000111010101110101111000111
11110111 1110101 101111010001
11111111 1111111 111111111111
