R 1280 720
NO ./cub3d_textures/wall_1.xpm
SO ./cub3d_textures/wall_2.xpm
WE ./cub3d_textures/wall_3.xpm
EA ./cub3d_textures/wall_4.xpm
S ./cub3d_textures/sprite_1.xpm
F 220,100,0
C 225,30,0

111111
1001011
102001
1100N1
111111
