R 1980 1080
NO ./cub3d_textures/wall_1.xpm
SO ./cub3d_textures/wall_2.xpm
WE ./cub3d_textures/wall_3.xpm
EA ./cub3d_textures/wall_4.xpm
S ./cub3d_textures/sprite_1.xpm
F 220,100,0
C 225,30,0

                 1111111
               11000000011
              1000000000001
             100000000000001
            10000000000000001
           1000000000000000001
            11000000000000011
              1000000000001
              1000000000001
              1000000000001
              1000000000001
              1000000000001
              1000000000001
              1000000000001
              1000000000001
              1000000000001
              1000000000001
              1000000000001
              1000000000001
        1111110000000000000111111
      11000000000000000000000000011
    110000000000000000000000000000011
   10000000000000000000000000000000001
  1000000000000000000000000000000000001
  11000000000000000000000000N0000000011
    100000000000000110000000000000001
     11000000000011  110000000000011
       1111111111      111111111111
