R 1920 1080
NO ./cub3d_textures/wood.xpm
WE ./cub3d_textures/wall_3.xpm
SO ./cub3d_textures/bluestone.xpm
EA ./cub3d_textures/wall_4.xpm
S ./cub3d_textures/sprite_1.xpm
F 220,100,0
C 225,30,0

111111111111111111111111111111111111111111111111111111111111
100000000000000000000000000000000000000000000000000000000001
100000000000000000000000000000000000000001000000000000000001
100000000000002000000000000000000000000000000000000000000001
100000020000000000000000000000000000000000000000000000000001
1000000000000000000000000000W0000000000000000000000000000001
100000000000000000000000000000000000000111111111111100000001
100000000020000000000000000000000000000000000000000000000001
100000000000000000000000000000000000000000000000000000000001
100000000000000000000000000000000000000000000000000000000001
100000000000000000020000000000000000001111111000000000000001
100000000000000000000000000000000000000000000000000000000001
100000000000000000000000000000000000000000000000000000000001
111111000000000000000000000000000000000000000000000000000001
100000000000000001111100000000000100000000000000000000000001
100000000000000000000000000000000000000000000000000000000001
100000000000000000000000000000000000000000000111111000000001
100000000000000000000000000000000000000000000000000000000001
100000000000000000000000000000000000000000000000000000000001
111111111111111111111111111111111111111111111111111111111111
